R 1920 1080
NO textures/brick_red.xpm
SO textures/brick_red_dark.xpm
WE textures/brick_red.xpm
EA textures/brick_red_dark.xpm
F 55,86,205
C 26,26,26
S sprites/flag.xpm

11111111111
10000000001
10000000001
10020000001
10000000001
10000002001
10000000001
10000N00001
11111111111