R 1920 1080
NO textures/brick_red.xpm
SO textures/brick_red_dark.xpm
WE textures/brick_red.xpm
EA textures/brick_red_dark.xpm
F 55,86,205
C 26,26,26
S sprites/438.xpm

11111111111
100000S0001
10000000001
10000000001
10000000001
10000000001
10000000001
12222222221
11111111111