R 1920 1080
NO textures/brick_red.xpm
SO textures/brick_red_dark.xpm
WE textures/brick_red.xpm
EA textures/brick_red_dark.xpm
F 55,86,205
C 26,26,26
S sprites/flag.xpm
11111111111
100000000111111111
10000000E0000000001
1111111111100000001
1111111111100000001
1000000000000000001
1000111001111111001
1001  1001000001001
1001  1001002001001
10001 10010000001111
10001 10010000000111
100001100100000000111
100001100100000000011
111111100100000000001
      100000000000001
      111111111111111
