R 1920 1080
NO textures/brown_b.xpm
SO textures/multi_b.xpm
WE textures/snow_b.xpm
EA textures/stone.xpm
S sprites/guard.xpm
F 1,1,1
C 225,30,26


11111111
1N000001
10000001
10001111
10111111
10000001
11111111