R 1920 1080
NO textures/brick_red.xpm
SO textures/brick_red_dark.xpm
WE textures/brick_red.xpm
EA textures/brick_red_dark.xpm
F 55,86,205
C 26,26,26
S sprites/guard.xpm

1111111111111111111111111111
1000000000000000000000000001
10000000000000S0000000000001
1000000000000000000000000001
1000000000000000000000000001
1000000000000000000000010001
1000000010000010000000000001
1000000000000010000000000001
1000000000000010000000000001
1000000010000000000000100001
1000000000000000000000000001111111111111
1000000000000000001000000000000000000001
1000000000000000000000000001000000000001
1111111111111111111111111111000000101111
                           1111111111