R 1920 1080
NO textures/texture_brick.xpm
SO textures/multi_b.xpm
WE textures/snow_b.xpm
EA textures/stone.xpm
F 55,86,205
C 26,26,26
S sprites/guard.xpm

11111111111111
10000000000001
10000000001001
100000E0001001
10000000001001
11111111111111