R 1920 1080
NO textures/brown_b.xpm
SO textures/multi_b.xpm
WE textures/snow_b.xpm
EA textures/stone.xpm
F 0,0,0
C 225,30,26
S sprites/guard.xpm

111111111
101000011
10000W001
100000001
100000001
100000001
100000001
100000001
100000001
100000001
100000001
100000001
111111111