R 1920 1080
NO textures/brick_red.xpm
SO textures/brick_red_dark.xpm
WE textures/brick_red.xpm
EA textures/brick_red_dark.xpm
F 55,86,205
C 26,26,26
S sprites/438.xpm

1111111
1222221
1000001
1000001
1000001
100N001
1000001
1111111