R 1200 1000
NO textures/brick_red.xpm
SO textures/brick_red_dark.xpm
WE textures/brick_red.xpm
EA textures/brick_red_dark.xpm
S sprites/soldier.xpm
F 0,86,205
C 26,26,26


11111111111111111
10000000000000101
10100000000100001
10001000000000001
10010000000010001
10101000000000101
1110000N000100001
10001000000000101
10100002000100001
10001000000000101
10100000000100001
10001000000000101
11111111111111111