R 1920 1000
NO textures/brick_red.xpm
SO textures/brick_red_dark.xpm
WE textures/brick_red.xpm
EA textures/brick_red_dark.xpm
F 55,86,205
C 26,26,26
S sprites/armor.xpm

11111111111
100000S0001
10000200001
10000020001
10000002001
10000000001
10000000001
10000000001
10000000001
11111111111