R 1920 1080
NO textures/brown_b.xpm
SO textures/multi_b.xpm
WE textures/snow_b.xpm
EA textures/stone.xpm
F 55,86,205
C 216,216,216
S sprites/guard.xpm

11111111111111
1000000E000001
10000000001001
10000000001001
10000000001001
11111111111111