R 1920 1080
NO textures/brown_b.xpm
SO textures/multi_b.xpm
WE textures/snow_b.xpm
EA textures/stone.xpm
F 000000000000216,216,216
C 0,185,255
S sprites/guard.xpm

111111111111111111111111
100000000000000000000001
100000000000000000000001
100000000000000000000001
100000000000000000000001
100001110000000000000001
100001110000000000000001
100001110000000000000001
100000000000000000000001
100000000000000000000001
100000000000000000000001
100000000000000000000001
100000000000000000000001
100000000000000000000001
100000000000000000000001
100000000000000000000001
100000000000000000000001
100000000000000000000001
10000000000N000000000001
100000000000000000000001
100000000000000000000001
100000000000000000000001
100000000000000000000001
100000000000000000000001
100000000000000000000001
100000000000000000000001
100000000000000000000001
111111111111111111111111