R 1920 1080
NO textures/brick_red.xpm
SO textures/brick_red_dark.xpm
WE textures/brick_red.xpm
EA textures/brick_red_dark.xpm
F 55,86,205
C 26,26,26
S sprites/flag.xpm
1111111111111
10000S0000001
1000000000001
1000000000001
1000000000001
1000020002001
1000000000001
1111111111111
